###############
###############
###############
#######O#######
#######O#######
###         ###
##  # # # #  ##
#  ##     ##  #
# ##  # #  ## #
#     BPB     #
####  ###  ####
###############
###############
###############
###############
