########
# O  O #
#      #
#  ##  #
#    P #
# BB   #
#      #
########
