#######
#OB   #
#  B  #
#  O  #
# #####
#   P##
#######
