###############
###############
######   ######
##### B B #####
###   # #   ###
##           ##
# B#  OOO #B  #
#     OPO     #
#  B# OOO  #B #
##           ##
###   # #   ###
##### B B #####
######   ######
###############
###############
