###################
#######   #   #   #
#######   B   B   #
#######   #   #   #
########B#######B##
#OOO  #   #   #   #
#OOO  B   B P #   #
#OOO  #   #   #   #
################B##
#######   #   #   #                  
#######   B   B   #                  
#######   #   #   #                  
###################
###################
###################
###################
###################
###################
###################