#######
#O   O#
# BBB #
# BPB #
#OBBBO#
#OO OO#
#######
