################
##########  ####
##########B ####
#######        #
####### ##O### #
####### ###### #
####### OPB ## #
########### ## #
###   ##O## ## #
### #       ## #
# B   # B##### #
# ###O#  #   BO#
#   ######    ##
#   BO     #####
################
################
