#########
#O     O#
####B ###
#       #
#B# P #B#
# # B # #
# #   # #
#O#   #O#
#########
