#########
#O B B O#
##     ##
#       #
#B  P  B#
#       #
#       #
#O     O#
#########
