#####
#O  #
# P #
#B  #
#####
